....................
...........e.s......
.........rbgoy......
..b.e..S............
..ryoGBR............
..........s.........
.........OYR........
...............e....
....RBG...g...BGO...
.+....s...b...S...s.
rrbbggooyyrbgoyrbgoy